W W W W W W W W W W W W W W W W W
W F F F F F F F F F F F F F F F W
W B B B B B F B B B B B B B B B W
W B B B B B F B B B B B B B B B W
W B B B B B F B B B B B B B B B W
W B B B B B F B B B B B B B B B W
W B B B B B F B B B B B B B B B W
W B B B B B F B B B B B B B B B W
W B B B B B F B B B B B B B B B W
W B B B B B F F F F F F B B B B W
W B B B B B B B B B B F B B B B W
W B B B B B B B B B B F B B B B W
W B B B B B B B B B B F B B B B W
W B B B B B B B B B B F B B B B W
W B B F F F F F F F F F B B B B W
W B B F B B B B B B B B B B B B W
W B B F B B B B B B B B B B B B W
W W W W W W W W W W W W W W W W W